Drones: 3
Drone 1: 0 0
Drone 2: 1 0
Drone 3: 2 0
Aim: *

15 15

D 0 0 0 0 0 1 1 1 0 0 0 0 0 0
D 0 0 0 0 0 1 1 1 0 0 0 0 0 0
D 0 0 0 0 0 1 1 1 0 0 0 0 0 0
1 1 0 0 0 0 1 1 1 0 0 0 0 0 0
1 1 0 0 0 0 0 0 0 0 0 0 0 0 0
0 0 0 0 0 0 0 0 0 0 0 0 0 1 1
0 0 0 0 0 0 1 1 1 0 0 0 0 1 1
0 0 1 1 0 0 1 1 1 0 0 0 0 1 1
0 0 1 1 0 0 1 1 1 0 0 0 0 0 0
0 0 0 0 0 0 0 0 0 0 1 1 1 0 0
0 0 0 0 0 0 0 0 0 0 1 1 1 0 0
0 0 0 1 1 0 0 0 0 0 1 1 1 0 0
0 0 0 1 1 0 0 1 1 0 0 0 0 0 0
0 0 0 1 1 0 0 1 1 0 0 0 0 0 0
0 0 0 1 1 * 0 1 1 0 0 0 0 0 0
