Drones: 3
Drone 1: 0 0
Drone 2: 1 0
Drone 3: 2 0
Aim: *
Objects: 3
Object 1: #
Object 2: %
Object 3: &

15 15

D 0 0 0 0 0 0 0 0 0 0 0 0 0 #
D 0 0 0 0 0 0 0 0 0 0 0 0 0 0
D 0 0 0 0 0 0 0 0 0 0 0 0 0 0
1 1 1 1 1 1 1 1 1 1 1 1 0 0 1
1 1 1 1 1 1 1 1 1 1 1 1 0 0 1
1 1 1 1 1 1 1 1 1 1 1 1 0 0 1
0 0 0 0 0 0 0 0 0 0 0 0 0 0 %
0 0 0 0 0 0 0 0 0 0 0 0 0 0 0
0 0 0 0 0 0 0 1 1 1 1 1 1 1 1
0 & 0 1 1 0 0 0 0 1 1 1 1 1 1
0 0 0 0 0 0 0 1 1 1 1 1 1 1 1
0 0 0 0 0 0 0 0 0 0 0 1 1 * 0
1 1 1 1 1 1 1 1 1 0 0 0 1 1 0
1 1 1 1 1 1 1 1 1 0 0 0 1 1 0
1 1 1 1 1 1 1 1 1 0 0 0 0 0 0