Drones: 3
Drone 1: 0 0
Drone 2: 0 1
Drone 3: 1 0
Aim: *

15 15

D D 1 1 # 0 0 0 0 0 0 0 0 0 *
D 0 1 1 0 0 0 0 0 0 0 0 0 0 0
0 0 1 1 0 0 0 0 0 0 0 0 0 0 0
0 0 1 1 0 0 0 0 0 0 0 0 0 0 0
0 0 1 1 0 0 0 0 0 0 0 0 0 0 0
0 0 1 1 0 0 % 1 1 1 1 1 1 1 0
0 0 1 1 0 0 0 1 1 1 1 1 1 1 0
0 0 1 1 0 0 0 1 1 1 1 1 1 1 0
0 0 1 1 0 0 0 1 1 0 0 0 0 0 0
0 0 1 1 0 0 0 1 1 0 0 0 0 0 0
0 0 1 1 0 0 0 1 1 0 0 0 & 0 0
0 0 0 0 0 0 0 1 1 0 0 0 0 1 1
0 0 0 0 0 0 0 1 1 0 0 0 0 1 1
0 0 0 0 0 0 0 1 1 0 0 0 0 0 0
0 0 0 0 0 0 0 1 1 0 0 0 0 0 0
